#############
#@....#B...q#
#.....#.....#
#...........#
#.....BK....#
#############